10
-.-.-.-.P.-.-.-.-.-
-.-.-.-.-.-.W.P.-.-
-.-.-.-.-.-.-.-.-.-
-.-.-.-.-.-.W.-.-.-
-.P.G.W.-.-.-.-.-.-
-.-.-.-.-.P.W.W.-.-
-.-.-.-.-.-.G.-.-.-
-.-.-.-.P.-.P.-.-.-
-.-.A.-.-.-.-.-.-.-
-.-.-.-.-.-.-.-.-.-