7
-.-.-.W.-.-.-
-.-.-.W.-.-.-
-.G.-.-.-.-.P
-.-.-.-.-.-.W
-.-.G.W.-.-.-
-.-.-.-.-.P.W
-.-.G.-.A.-.-