10
-.-.-.-.P.-.-.-.-.-
-.W.-.-.-.P.W.P.-.-
-.P.W.-.-.-.-.-.-.-
-.-.-.-.-.-.W.-.-.-
-.-.G.W.-.-.-.-.-.-
-.-.P.-.-.P.W.W.-.-
-.-.-.-.-.-.P.W.-.-
W.-.-.-.W.-.P.-.-.-
-.-.A.-.-.-.-.-.-.-
-.-.-.G.-.-.-.-.-.-