5
-.A.-.-.P
P.-.-.W.-
-.G.-.-.-
P.-.-.-.-
-.-.G.-.P