8
P.-.-.-.W.-.-.-
-.-.-.-.-.-.W.W
-.G.-.-.-.G.-.-
-.-.-.-.-.-.W.-
-.W.G.-.-.-.-.-
-.-.-.-.-.P.W.W
-.G.-.-.-.W.G.-
-.-.P.-.W.-.P.-